/thisfileisformap/
A
104	102	102	102	102	102	102	103
108	101	101	101	101	101	101	100
108	101	101	101	101	101	101	100
108	101	101	101	101	101	101	100
108	101	101	101	101	101	101	100
108	101	101	101	101	101	101	100
108	101	101	101	101	101	101	100
107	105	105	105	105	105	105	106
endl